006660000
006360000
006066660
666202360
630216660
666626000
000636000
000666000
000000000