666666600
633233600
633633600
602220600
600600600
606660600
600610600
666666600
000000000