066666000
060106660
660620060
605303060
600220660
666063600
006000600
006666600
000000000