666666000
600006000
602016000
665006000
605066000
605060000
605060000
602060000
666660000