006666000
006006000
666206600
600500600
600501600
600506600
666506000
006366000
006660000