666660000
600066666
606060006
602000206
633626266
631200060
633006660
666666000
000000000