066666600
060000660
663002060
603320060
600620060
600106660
666666000
000000000
000000000