666660000
600160000
602260666
602060636
666066636
066000036
060006006
060006666
066666000