066660000
660060000
601260000
662066000
660206000
632006000
633536000
666666000
000000000