066660000
060066600
061200600
666060660
636060060
632006060
630002060
666666660
000000000