006666660
006000060
666222060
610233060
602333660
666600600
000666600
000000000
000000000