006666600
666000600
600231660
600323060
666052060
006000660
006666600
000000000
000000000