006666000
006336000
066036600
060023600
660200660
600622060
600100060
666666660
000000000