666666660
600600060
612332060
602350660
602332060
600600060
666666660
000000000
000000000