666666000
600006000
602226600
600633666
660033206
060100006
066666666
000000000
000000000